{
  "levels": [
    {
      "grid": [
        [1, 1, 1, 1, 1, 1, 1, 1, 1, 1],
        [1, 2, 0, 0, 0, 1, 0, 0, 0, 1],
        [1, 0, 1, 1, 0, 1, 0, 1, 0, 1],
        [1, 0, 1, 0, 0, 0, 0, 1, 0, 1],
        [1, 0, 1, 0, 1, 1, 0, 1, 0, 1],
        [1, 0, 0, 0, 0, 0, 0, 0, 3, 1],
        [1, 1, 1, 1, 1, 1, 1, 1, 1, 1]
      ],

      "obstacles": [
        { "r": 1, "c": 2 },
        { "r": 3, "c": 4 }
      ],

      "words": [
        { "r": 1, "c": 2, "text": "GO" },
        { "r": 5, "c": 8, "text": "EXIT" }
      ]
    },

    {
      "grid": [
        [1, 1, 1, 1, 1, 1, 1, 1, 1, 1],
        [1, 2, 0, 0, 1, 0, 0, 0, 3, 1],
        [1, 0, 1, 0, 1, 0, 1, 0, 1, 1],
        [1, 0, 1, 0, 0, 0, 1, 0, 0, 1],
        [1, 0, 0, 0, 1, 0, 0, 1, 0, 1],
        [1, 1, 1, 0, 1, 0, 0, 1, 0, 1],
        [1, 1, 1, 1, 1, 1, 1, 1, 1, 1]
      ],

      "obstacles": [
        { "r": 3, "c": 1 },
        { "r": 4, "c": 2 },
        { "r": 4, "c": 7 }
      ],

      "words": [
        { "r": 1, "c": 2, "text": "GO" },
        { "r": 1, "c": 8, "text": "EXIT" }
      ]
    }
  ]
}
